111111
1PC0E1
110111
10CCC1
111111