1111111111111111111
1P10101000000010001
1011000001000010001
1010011111C10011111
10001000100100000E1
1111111111111111111
