1111111111111111111111111111111111
100000000000000C00000C000000000001
101001010C100000101001000000010101
101001001C101010001001000000010101
1P0000001E10C0000000000000000000C1
1111111111111111111111111111111111