1111111111111111111
1E00000000000000001
1000000000000000001
1000000000C00000001
10000000000000000P1
1111111111111111111
