1111111111111111111
1P10000000000000001
1010000001000000001
1010000001C10011101
10001000000100001E1
1111111111111111111
